R 680 420
NO textures/wall_n.xpm
SO textures/wall_s.xpm
WE textures/wall_w.xpm
EA textures/wall_e.xpm
S textures/barrel.xpm
F 150, 75, 234
C 224, 0, 243

        11111111111111111111111111
        10000000000110000000000001
        10110000201010000002000001
        10010002000000000W00000011
111111111011000201110000000000001
100000000011000001110111111111111
11110111111111011100000010001
11110111111111011101010011111
11000000110101011100000010001
1000200000000000110000010001
10000000000000001101010010001
1100000111010101111101111000111
11110111 1110101 101111010001
11111111 1111111 111111111111